%%%%%%%%%%%%%%%%%%%%%%%%%
%.. P  ....  W   ....  W%
%..  ...  ...W ...  ... %
%..  ...  ...W ...  ... %
%..    .WW.  W   .... G %
%..  ...  ...W ...  ... %
%..  ...  ...W ...  ... %
%..    ....  W   ....  o%
%%%%%%%%%%%%%%%%%%%%%%%%%